"aa" = (/turf/unsimulated/wall,/area/planet/clown)
"ab" = (/turf/simulated/mineral/random/clown,/area/planet/clown)
"ac" = (/obj/item/weapon/ore/clown,/obj/item/weapon/ore/clown,/obj/item/weapon/ore/clown,/obj/item/weapon/ore/clown,/obj/item/weapon/ore/clown,/turf/simulated/floor/grass,/area/planet/clown)
"ad" = (/turf/simulated/wall/mineral/clown,/area/planet/clown)
"ae" = (/obj/effect/landmark/corpse/clown,/obj/effect/decal/cleanable/blood,/turf/simulated/floor/grass,/area/planet/clown)
"af" = (/turf/simulated/floor/grass,/area/planet/clown)
"ag" = (/obj/item/weapon/pickaxe/diamonddrill,/obj/effect/landmark/corpse/clown,/obj/effect/decal/cleanable/blood,/turf/simulated/floor/grass,/area/planet/clown)
"ah" = (/obj/structure/ore_box,/obj/item/stack/sheet/mineral/clown,/obj/item/stack/sheet/mineral/clown,/obj/item/stack/sheet/mineral/clown,/obj/item/stack/sheet/mineral/clown,/turf/simulated/floor{dir = 8; icon_state = "barber"},/area/planet/clown)
"ai" = (/obj/item/seeds/bananaseed,/turf/simulated/floor{dir = 8; icon_state = "barber"},/area/planet/clown)
"aj" = (/obj/item/weapon/pickaxe,/turf/simulated/floor/plating,/area/planet/clown)
"ak" = (/turf/simulated/floor/plating,/area/planet/clown)
"al" = (/obj/effect/decal/remains/human,/turf/simulated/floor/plating,/area/planet/clown)
"am" = (/obj/effect/decal/remains/human,/obj/item/clothing/head/helmet/space/rig/ancient,/obj/item/clothing/suit/space/rig/ancient,/obj/effect/decal/cleanable/blood,/turf/simulated/floor/grass,/area/planet/clown)
"an" = (/obj/item/weapon/paper/crumpled/bloody{info = "I was told getting the bananium would be easy...fuck...they lied...send word to my family in the Alpha Minorious Sector if you find this."},/turf/simulated/floor/grass,/area/planet/clown)
"ao" = (/obj/item/seeds/bananaseed,/mob/living/simple_animal/hostile/asteroid/goldgrub,/turf/simulated/floor{dir = 8; icon_state = "barber"},/area/planet/clown)
"ap" = (/obj/item/seeds/bananaseed,/obj/effect/landmark/corpse/clown,/obj/effect/decal/cleanable/blood,/turf/simulated/floor{dir = 8; icon_state = "barber"},/area/planet/clown)
"aq" = (/obj/item/seeds/bananaseed,/obj/effect/decal/cleanable/blood,/turf/simulated/floor{dir = 8; icon_state = "barber"},/area/planet/clown)
"ar" = (/obj/effect/landmark/corpse/clown,/obj/effect/decal/cleanable/blood,/turf/simulated/floor{dir = 8; icon_state = "barber"},/area/planet/clown)
"as" = (/obj/item/weapon/ore/clown,/obj/item/weapon/ore/clown,/obj/item/weapon/ore/clown,/obj/item/weapon/ore/clown,/obj/item/weapon/ore/clown,/obj/item/weapon/ore/clown,/turf/simulated/floor/grass,/area/planet/clown)
"at" = (/obj/structure/barricade/wooden,/turf/simulated/floor/grass,/area/planet/clown)
"au" = (/turf/simulated/floor{dir = 8; icon_state = "barber"},/area/planet/clown)
"av" = (/obj/effect/decal/cleanable/blood,/turf/simulated/floor{dir = 8; icon_state = "barber"},/area/planet/clown)
"aw" = (/mob/living/simple_animal/hostile/asteroid/goliath,/turf/simulated/floor{dir = 8; icon_state = "barber"},/area/planet/clown)
"ax" = (/obj/machinery/door/airlock/clown,/turf/simulated/floor/grass,/area/planet/clown)
"ay" = (/obj/machinery/mineral/input,/obj/effect/decal/cleanable/blood,/turf/simulated/floor{dir = 8; icon_state = "barber"},/area/planet/clown)
"az" = (/obj/machinery/mineral/mint,/turf/simulated/floor{dir = 8; icon_state = "barber"},/area/planet/clown)
"aA" = (/obj/machinery/mineral/output,/turf/simulated/floor{dir = 8; icon_state = "barber"},/area/planet/clown)
"aB" = (/obj/effect/decal/remains/human,/turf/simulated/floor{dir = 8; icon_state = "barber"},/area/planet/clown)
"aC" = (/obj/item/stack/sheet/mineral/clown,/obj/item/stack/sheet/mineral/clown,/turf/simulated/floor/grass,/area/planet/clown)
"aD" = (/obj/structure/ore_box,/turf/simulated/floor/grass,/area/planet/clown)
"aE" = (/obj/item/stack/sheet/mineral/clown,/obj/item/stack/sheet/mineral/clown,/obj/item/weapon/pickaxe,/turf/simulated/floor/grass,/area/planet/clown)
"aF" = (/obj/structure/flora/ausbushes/brflowers,/turf/simulated/floor/grass,/area/planet/clown)
"aG" = (/obj/structure/flora/ausbushes/ppflowers,/mob/living/simple_animal/hostile/retaliate/clown,/turf/simulated/floor/grass,/area/planet/clown)
"aH" = (/obj/structure/flora/ausbushes/ppflowers,/turf/simulated/floor/grass,/area/planet/clown)
"aI" = (/obj/structure/flora/ausbushes/brflowers,/obj/structure/flora/ausbushes/ppflowers,/turf/simulated/floor/grass,/area/planet/clown)
"aJ" = (/obj/structure/flora/ausbushes/ppflowers,/obj/structure/flora/ausbushes/lavendergrass,/turf/simulated/floor/grass,/area/planet/clown)
"aK" = (/obj/structure/flora/ausbushes/lavendergrass,/mob/living/simple_animal/hostile/retaliate/clown,/turf/simulated/floor/grass,/area/planet/clown)
"aL" = (/obj/structure/flora/ausbushes/lavendergrass,/turf/simulated/floor/grass,/area/planet/clown)
"aM" = (/obj/structure/flora/ausbushes/brflowers,/obj/structure/flora/ausbushes/ppflowers,/mob/living/simple_animal/hostile/retaliate/clown,/turf/simulated/floor/grass,/area/planet/clown)
"aN" = (/obj/structure/flora/ausbushes/ppflowers,/obj/structure/flora/ausbushes/brflowers,/turf/simulated/floor/grass,/area/planet/clown)
"aO" = (/obj/structure/flora/ausbushes/ppflowers,/obj/structure/flora/ausbushes/brflowers,/obj/structure/flora/ausbushes/lavendergrass,/turf/simulated/floor/grass,/area/planet/clown)
"aP" = (/obj/structure/flora/ausbushes/brflowers,/obj/structure/flora/ausbushes/lavendergrass,/turf/simulated/floor/grass,/area/planet/clown)
"aQ" = (/obj/structure/flora/ausbushes/lavendergrass,/obj/structure/flora/ausbushes/ppflowers,/turf/simulated/floor/grass,/area/planet/clown)
"aR" = (/obj/machinery/gateway{dir = 9},/obj/structure/flora/ausbushes/ppflowers,/turf/simulated/floor/grass,/area/planet/clown)
"aS" = (/obj/machinery/gateway{dir = 1},/turf/simulated/floor/grass,/area/planet/clown)
"aT" = (/obj/machinery/gateway{dir = 5},/obj/structure/flora/ausbushes/ppflowers,/turf/simulated/floor/grass,/area/planet/clown)
"aU" = (/obj/structure/flora/ausbushes/ppflowers,/obj/structure/flora/ausbushes/brflowers,/mob/living/simple_animal/hostile/retaliate/clown,/turf/simulated/floor/grass,/area/planet/clown)
"aV" = (/obj/structure/flora/ausbushes/brflowers,/mob/living/simple_animal/hostile/retaliate/clown,/turf/simulated/floor/grass,/area/planet/clown)
"aW" = (/obj/machinery/gateway{dir = 8},/turf/simulated/floor/grass,/area/planet/clown)
"aX" = (/obj/machinery/gateway/centeraway,/turf/simulated/floor/grass,/area/planet/clown)
"aY" = (/obj/machinery/gateway{dir = 4},/turf/simulated/floor/grass,/area/planet/clown)
"aZ" = (/obj/structure/table/woodentable,/obj/item/clothing/mask/gas/clown_hat,/obj/item/clothing/gloves/rainbow/clown,/obj/item/clothing/shoes/clown_shoes{desc = "These shoes appear var-edited!."; name = "uhangi's shoes"; slowdown = -1},/obj/item/clothing/under/rank/clown,/obj/item/device/pda/clown,/obj/item/weapon/storage/backpack/clown,/turf/simulated/floor/grass,/area/planet/clown)
"ba" = (/obj/structure/table/woodentable,/obj/item/seeds/cashseed,/obj/item/seeds/cashseed,/turf/simulated/floor/grass,/area/planet/clown)
"bb" = (/obj/machinery/gateway{dir = 10},/obj/structure/flora/ausbushes/ppflowers,/turf/simulated/floor/grass,/area/planet/clown)
"bc" = (/obj/machinery/gateway,/turf/simulated/floor/grass,/area/planet/clown)
"bd" = (/obj/machinery/gateway{dir = 6},/obj/structure/flora/ausbushes/ppflowers,/turf/simulated/floor/grass,/area/planet/clown)
"be" = (/obj/structure/flora/ausbushes/ppflowers,/obj/structure/flora/ausbushes/brflowers,/obj/structure/flora/ausbushes/lavendergrass,/mob/living/simple_animal/hostile/retaliate/clown,/turf/simulated/floor/grass,/area/planet/clown)
"bf" = (/obj/structure/flora/ausbushes/brflowers,/obj/structure/flora/ausbushes/lavendergrass,/mob/living/simple_animal/hostile/retaliate/clown,/turf/simulated/floor/grass,/area/planet/clown)
"bg" = (/obj/structure/flora/ausbushes/lavendergrass,/obj/structure/flora/ausbushes/ppflowers,/mob/living/simple_animal/hostile/retaliate/clown,/turf/simulated/floor/grass,/area/planet/clown)
"bh" = (/obj/structure/flora/ausbushes/ppflowers,/obj/structure/flora/ausbushes/brflowers,/obj/structure/flora/ausbushes/lavendergrass,/obj/structure/signpost{desc = "The sign says: Please don't mine the Bananium!"; name = "Welcome to Clown Planet"},/turf/simulated/floor/grass,/area/planet/clown)
"bi" = (/obj/structure/flora/ausbushes/brflowers,/obj/structure/flora/ausbushes/ppflowers,/obj/structure/flora/ausbushes/brflowers,/obj/structure/flora/ausbushes/lavendergrass,/turf/simulated/floor/grass,/area/planet/clown)
"bj" = (/obj/structure/flora/ausbushes/brflowers,/obj/structure/flora/ausbushes/brflowers,/obj/structure/flora/ausbushes/lavendergrass,/turf/simulated/floor/grass,/area/planet/clown)
"bk" = (/obj/structure/flora/ausbushes/lavendergrass,/obj/structure/flora/ausbushes/ppflowers,/obj/structure/flora/ausbushes/ppflowers,/turf/simulated/floor/grass,/area/planet/clown)
"bl" = (/mob/living/simple_animal/hostile/retaliate/clown,/turf/simulated/floor/grass,/area/planet/clown)
"bm" = (/obj/machinery/hydroponics/soil,/turf/simulated/floor/grass,/area/planet/clown)
"bn" = (/obj/structure/flora/ausbushes/lavendergrass,/obj/structure/flora/ausbushes/ppflowers,/obj/structure/flora/ausbushes/brflowers,/turf/simulated/floor/grass,/area/planet/clown)
"bo" = (/obj/structure/flora/ausbushes/lavendergrass,/obj/structure/flora/ausbushes/ppflowers,/obj/structure/flora/ausbushes/brflowers,/mob/living/simple_animal/hostile/retaliate/clown,/turf/simulated/floor/grass,/area/planet/clown)
"bp" = (/obj/structure/flora/ausbushes/palebush,/turf/simulated/floor/grass,/area/planet/clown)
"bq" = (/obj/structure/flora/ausbushes/sunnybush,/turf/simulated/floor/grass,/area/planet/clown)
"br" = (/obj/structure/flora/ausbushes/brflowers,/obj/structure/flora/ausbushes/sunnybush,/turf/simulated/floor/grass,/area/planet/clown)
"bs" = (/obj/structure/mineral_door/gold,/turf/simulated/floor{dir = 8; icon_state = "barber"},/area/planet/clown)
"bt" = (/obj/structure/stool/bed/chair/comfy/lime,/mob/living/simple_animal/hostile/retaliate/clown,/turf/simulated/floor{dir = 8; icon_state = "barber"},/area/planet/clown)
"bu" = (/obj/structure/table/reinforced,/obj/item/clothing/gloves/rainbow/clown,/turf/simulated/floor{dir = 8; icon_state = "barber"},/area/planet/clown)
"bv" = (/obj/structure/stool/bed/chair/office/light{dir = 8},/mob/living/simple_animal/hostile/retaliate/clown,/turf/simulated/floor{dir = 8; icon_state = "barber"},/area/planet/clown)
"bw" = (/obj/structure/filingcabinet,/turf/simulated/floor{dir = 8; icon_state = "barber"},/area/planet/clown)
"bx" = (/obj/machinery/door/window/westleft,/turf/simulated/floor{dir = 8; icon_state = "barber"},/area/planet/clown)
"by" = (/turf/simulated/floor{dir = 1; icon_state = "warning"},/area/planet/clown)
"bz" = (/obj/machinery/gun_turret,/turf/simulated/floor{dir = 1; icon_state = "warning"},/area/planet/clown)
"bA" = (/turf/simulated/floor,/area/planet/clown)
"bB" = (/obj/structure/closet/crate,/obj/item/stack/sheet/mineral/clown,/obj/item/stack/sheet/mineral/clown,/obj/item/stack/sheet/mineral/clown,/obj/item/stack/sheet/mineral/clown,/obj/item/stack/sheet/mineral/clown,/obj/item/stack/sheet/mineral/clown,/turf/simulated/floor,/area/planet/clown)

(1,1,1) = {"
aaaaaaaaaaaaaaaaaaaaaaaaaaaaaaaaaaaaaaaaaaaaaaaaaaaaaaaaaaaaaaaaaaaaaaaaaaaaaaaa
aaababababababababababababababababababababababababababababababababababababababaa
aaababababababababababababababababababababababababababababababababababababababaa
aaabababababababababababababacabababababababababababadababababababadabababababaa
aaababababababababababaeafafafagababababababababababafafababahahaiajakalabababaa
aaababababababababababababafamanafabababababababababafafadaiaoapaqarakakabababaa
aaababababababababababafafaeafabasabababababababababafafatauavauauawauakabababaa
aaababababababababababababacabababababababababababababafaxauayazaAauauaBabababaa
aaabababababababababababacacabababababababababababababafadatatadadatadadadababaa
aaabababababababababababababababababababababababababafafafafafababaCaCaCaCababaa
aaababababababababababababababababababababababababababafafafafabababaDaDaEababaa
aaabababababababababababababababababababababababababababafafafabababababaDababaa
aaababababababababababababababababababababababababababababababababababababababaa
aaababababababababababababababababababababababababababababababababababababababaa
aaabababababafafabababababafafababababababababababababababababababababababababaa
aaabababababafafafafaFaFaFafafafabababafafababababababababababababababababababaa
aaabababababafaGaHaHaIaIaIaHaHaHaHaJaKaLafafabababababababababababababababababaa
aaababababafafaHaHaHaIaIaIaHaHaHaHaJaLaLafafabababafabababababababababababababaa
aaababababababaHaHaHaIaMaIaHaNaNaNaOaPaPafafafafafafafababababababababababababaa
aaabababababaLaQaQaQaIaIaRaSaTaUaUaUaVaVafafafafafabafababababababababababababaa
aaababababafaLaQaQaQaQaQaWaXaYaZbabababaaLafafafafababababababababababababababaa
aaabababababaFaIaIaMaQaQbbbcbdbebebebebfaLafafafafafabababababababababababababaa
aaababababafaFaFaFaFaLaLbgaHaOaOaOaOaOaPaLafafafafafabababababababababababababaa
aaababababafaFaFaFaFaLaLaQaHaObhaObibibjaPaFafafafababababababababababababababaa
aaabababababaFaFaFaIaQaQbkaHaOaOaObibibjaPaFafblbmababababababababababababababaa
aaabababababababafaHaQaQbnaFaPaPaPbfaPaPaPaFafafbmababababababababababababababaa
aaababababababafafaHaQaQboaFaFaFaFaFaFaFaFaFbpbpbpababababababababababababababaa
aaababababbmafafafbqbqbqbraFaFaFbrbrbrbraFaFabababababababababababababababababaa
aaababababbmabafbmadadadadadbsadadadadadafababababababababababababababababababaa
aaabababababababbmadauaubtbtauaububvbwadabababababababababababababababababababaa
aaababababababababadadauauauauaubxaubwadabababababababababababababababababababaa
aaabababababababababadadadbsadadadadadadabababababababababababababababababababaa
aaabababababababababababadbybybybzadabababababababababababababababababababababaa
aaabababababababababababadbAbAbAbBadabababababababababababababababababababababaa
aaabababababababababababadbAbAbAbBadabababababababababababababababababababababaa
aaabababababababababababadbAbAbAbAadabababababababababababababababababababababaa
aaabababababababababababadbBbBbBbBadabababababababababababababababababababababaa
aaabababababababababababadadadadadadabababababababababababababababababababababaa
aaababababababababababababababababababababababababababababababababababababababaa
aaaaaaaaaaaaaaaaaaaaaaaaaaaaaaaaaaaaaaaaaaaaaaaaaaaaaaaaaaaaaaaaaaaaaaaaaaaaaaaa
"}
